aq=ako
u=ikaw
d2=dito
cno=sino
jan=diyan
kau=kayo
cn=sino
ksama=kasama
tau=tayo
niu=ninyo
kc=kasi
cge=sige
saatin=sa atin
ge=sige
kmi=kami
tnx=salamat
lodi=idol
petmalu=malupit
nde=hindi
q=ko
gnun=ganun
syota=kasintahan
skrrt=alis
gudam=magandang umaga
gudpm=magandang hapon
kasbu=bukas
omsim=mismo
lodi=idol
today=ngayon
d=hindi
tas=tapos
otw=papunta
lng=lang
di=hindi
wait=maghintay
me=ako
dami=madami
knina=kanina
bkas=bukas
to=ito
snb=sinabi
nian=niyan
u=ikaw
mustah=kamusta
musta=kamusta
xenxa=pasensya
cnbi=sinabi
sau= sa iyo
pdala=padala
kn=ka na
klngan=kailangan
pnta=punta
cnu-sino
b=ba
nsa=nasa
nyo=ninyo
maya=mamaya
maya-maya=mamaya